[Diary]
DiaryFilename=Dagbok.xlsx
DiarySheetPrefix=Dagbok
TimecodeSheetName=Timecodes

[DiaryColumns]
DateColumn=Datum
WeekColumn=Vecka
StartColumn=Start
EndColumn=Slut
StartColumn=Start
TimecodeKeyColumn=Timecode nyckel
ActivityColumn=Kommentar
ActualDateColumn=Faktiskt Datum
ActualstartColumn=Faktiskt Start
ActualEndColumn=Faktiskt Slut
ActualWorkedHoursColumn=Faktiskt Arbetade h
IsDebColumn=Deb?
ChargedHoursColumn=Debiterade h
LeftThisWeekColumn=Kvar
HoursColumn=h
MinutesColumn=m
TotalHoursColumn=Arbetade h
TagColumn=Tag
DescriptionColumn=Beskrivning

[TimecodeColumns]
KeyColumn=Key
TimecodeColumn=Timecode
TaskColumn=Task
TypeColumn=Type
CustomerColumn=Kund
TimeAvailableColumn=Time available
TimeSpentColumn=Time spent

[Export]
FileName=Week

[ProcessingPrompt]
Message=Extracting workbook into txt files. This may take a short while...

[OpenTimeReportingUrl]
Active=True
PromptTitle=Peter's Diary converter
PromptMessage=Diary has been converted to txt format and is ready to be imported in the company time reporting system! Would you like to open the time reporting system in internet explorer now?
TimeReportingUrl=

[Logging]
Active=False

